"filename", "language", "PHP", "JavaScript", "CSS", "comment", "blank", "total"
"c:\wamp64\www\PK\resources\css\app.css", "CSS", 0, 0, 3, 0, 1, 4
"c:\wamp64\www\PK\resources\js\app.js", "JavaScript", 0, 4, 0, 0, 4, 8
"c:\wamp64\www\PK\resources\js\bootstrap.js", "JavaScript", 0, 3, 0, 0, 2, 5
"c:\wamp64\www\PK\resources\views\auth\confirm-password.blade.php", "PHP", 22, 0, 0, 0, 6, 28
"c:\wamp64\www\PK\resources\views\auth\forgot-password.blade.php", "PHP", 21, 0, 0, 0, 5, 26
"c:\wamp64\www\PK\resources\views\auth\login.blade.php", "PHP", 48, 0, 0, 0, 10, 58
"c:\wamp64\www\PK\resources\views\auth\register-coach.blade.php", "PHP", 34, 0, 0, 0, 5, 39
"c:\wamp64\www\PK\resources\views\auth\register-player.blade.php", "PHP", 55, 0, 0, 0, 9, 64
"c:\wamp64\www\PK\resources\views\auth\register.blade.php", "PHP", 27, 0, 0, 0, 3, 30
"c:\wamp64\www\PK\resources\views\auth\reset-password.blade.php", "PHP", 32, 0, 0, 0, 8, 40
"c:\wamp64\www\PK\resources\views\auth\verify-email.blade.php", "PHP", 26, 0, 0, 0, 6, 32
"c:\wamp64\www\PK\resources\views\components\application-logo.blade.php", "PHP", 3, 0, 0, 0, 1, 4
"c:\wamp64\www\PK\resources\views\components\auth-session-status.blade.php", "PHP", 6, 0, 0, 0, 2, 8
"c:\wamp64\www\PK\resources\views\components\danger-button.blade.php", "PHP", 3, 0, 0, 0, 1, 4
"c:\wamp64\www\PK\resources\views\components\dropdown-link.blade.php", "PHP", 1, 0, 0, 0, 1, 2
"c:\wamp64\www\PK\resources\views\components\dropdown.blade.php", "PHP", 31, 0, 0, 0, 5, 36
"c:\wamp64\www\PK\resources\views\components\input-error.blade.php", "PHP", 8, 0, 0, 0, 2, 10
"c:\wamp64\www\PK\resources\views\components\input-label.blade.php", "PHP", 4, 0, 0, 0, 2, 6
"c:\wamp64\www\PK\resources\views\components\layout.blade.php", "PHP", 16, 0, 0, 0, 5, 21
"c:\wamp64\www\PK\resources\views\components\modal.blade.php", "PHP", 73, 0, 0, 2, 4, 79
"c:\wamp64\www\PK\resources\views\components\nav-bar.blade.php", "PHP", 11, 0, 0, 0, 1, 12
"c:\wamp64\www\PK\resources\views\components\primary-button.blade.php", "PHP", 3, 0, 0, 0, 1, 4
"c:\wamp64\www\PK\resources\views\components\responsive-nav-link.blade.php", "PHP", 9, 0, 0, 0, 3, 12
"c:\wamp64\www\PK\resources\views\components\secondary-button.blade.php", "PHP", 3, 0, 0, 0, 1, 4
"c:\wamp64\www\PK\resources\views\components\text-input.blade.php", "PHP", 2, 0, 0, 0, 2, 4
"c:\wamp64\www\PK\resources\views\contact.blade.php", "PHP", 0, 0, 0, 0, 1, 1
"c:\wamp64\www\PK\resources\views\dashboard.blade.php", "PHP", 15, 0, 0, 0, 2, 17
"c:\wamp64\www\PK\resources\views\dashboard\coach-dashboard.blade.php", "PHP", 17, 0, 0, 0, 6, 23
"c:\wamp64\www\PK\resources\views\dashboard\coach\manage-team.blade.php", "PHP", 38, 0, 0, 0, 6, 44
"c:\wamp64\www\PK\resources\views\dashboard\player-dashboard.blade.php", "PHP", 10, 0, 0, 0, 3, 13
"c:\wamp64\www\PK\resources\views\footer.blade.php", "PHP", 38, 0, 0, 0, 0, 38
"c:\wamp64\www\PK\resources\views\home.blade.php", "PHP", 69, 0, 0, 0, 8, 77
"c:\wamp64\www\PK\resources\views\layouts\app.blade.php", "PHP", 38, 0, 0, 0, 8, 46
"c:\wamp64\www\PK\resources\views\layouts\guest.blade.php", "PHP", 21, 0, 0, 0, 6, 27
"c:\wamp64\www\PK\resources\views\layouts\navigation.blade.php", "PHP", 0, 0, 0, 0, 1, 1
"c:\wamp64\www\PK\resources\views\options.blade.php", "PHP", 177, 0, 0, 0, 8, 185
"c:\wamp64\www\PK\resources\views\prices.blade.php", "PHP", 46, 0, 0, 0, 5, 51
"c:\wamp64\www\PK\resources\views\profile\edit.blade.php", "PHP", 26, 0, 0, 0, 4, 30
"c:\wamp64\www\PK\resources\views\profile\partials\delete-user-form.blade.php", "PHP", 45, 0, 0, 0, 11, 56
"c:\wamp64\www\PK\resources\views\profile\partials\update-password-form.blade.php", "PHP", 41, 0, 0, 0, 8, 49
"c:\wamp64\www\PK\resources\views\profile\partials\update-profile-information-form.blade.php", "PHP", 54, 0, 0, 0, 11, 65
"c:\wamp64\www\PK\resources\views\vendor\filament-panels\components\avatar\tenant.blade.php", "PHP", 12, 0, 0, 0, 2, 14
"c:\wamp64\www\PK\resources\views\vendor\filament-panels\components\avatar\user.blade.php", "PHP", 11, 0, 0, 0, 2, 13
"c:\wamp64\www\PK\resources\views\vendor\filament-panels\components\form\actions.blade.php", "PHP", 32, 0, 0, 0, 3, 35
"c:\wamp64\www\PK\resources\views\vendor\filament-panels\components\form\index.blade.php", "PHP", 13, 0, 0, 0, 2, 15
"c:\wamp64\www\PK\resources\views\vendor\filament-panels\components\global-search\actions.blade.php", "PHP", 12, 0, 0, 0, 2, 14
"c:\wamp64\www\PK\resources\views\vendor\filament-panels\components\global-search\field.blade.php", "PHP", 41, 0, 0, 0, 3, 44
"c:\wamp64\www\PK\resources\views\vendor\filament-panels\components\global-search\index.blade.php", "PHP", 16, 0, 0, 0, 4, 20
"c:\wamp64\www\PK\resources\views\vendor\filament-panels\components\global-search\no-results-message.blade.php", "PHP", 5, 0, 0, 0, 1, 6
"c:\wamp64\www\PK\resources\views\vendor\filament-panels\components\global-search\result-group.blade.php", "PHP", 27, 0, 0, 0, 3, 30
"c:\wamp64\www\PK\resources\views\vendor\filament-panels\components\global-search\result.blade.php", "PHP", 38, 0, 0, 0, 5, 43
"c:\wamp64\www\PK\resources\views\vendor\filament-panels\components\global-search\results-container.blade.php", "PHP", 42, 0, 0, 5, 4, 51
"c:\wamp64\www\PK\resources\views\vendor\filament-panels\components\header\index.blade.php", "PHP", 42, 0, 0, 0, 7, 49
"c:\wamp64\www\PK\resources\views\vendor\filament-panels\components\header\simple.blade.php", "PHP", 24, 0, 0, 0, 4, 28
"c:\wamp64\www\PK\resources\views\vendor\filament-panels\components\layout\base.blade.php", "PHP", 106, 0, 0, 0, 28, 134
"c:\wamp64\www\PK\resources\views\vendor\filament-panels\components\layout\index.blade.php", "PHP", 123, 0, 0, 0, 17, 140
"c:\wamp64\www\PK\resources\views\vendor\filament-panels\components\layout\simple.blade.php", "PHP", 60, 0, 0, 0, 6, 66
"c:\wamp64\www\PK\resources\views\vendor\filament-panels\components\logo.blade.php", "PHP", 52, 0, 0, 0, 6, 58
"c:\wamp64\www\PK\resources\views\vendor\filament-panels\components\page\index.blade.php", "PHP", 138, 0, 0, 0, 31, 169
"c:\wamp64\www\PK\resources\views\vendor\filament-panels\components\page\simple.blade.php", "PHP", 19, 0, 0, 0, 6, 25
"c:\wamp64\www\PK\resources\views\vendor\filament-panels\components\page\sub-navigation\select.blade.php", "PHP", 40, 0, 0, 0, 4, 44
"c:\wamp64\www\PK\resources\views\vendor\filament-panels\components\page\sub-navigation\sidebar.blade.php", "PHP", 26, 0, 0, 0, 4, 30
"c:\wamp64\www\PK\resources\views\vendor\filament-panels\components\page\sub-navigation\tabs.blade.php", "PHP", 71, 0, 0, 0, 7, 78
"c:\wamp64\www\PK\resources\views\vendor\filament-panels\components\page\unsaved-data-changes-alert.blade.php", "PHP", 65, 0, 0, 0, 12, 77
"c:\wamp64\www\PK\resources\views\vendor\filament-panels\components\resources\relation-managers.blade.php", "PHP", 104, 0, 0, 0, 13, 117
"c:\wamp64\www\PK\resources\views\vendor\filament-panels\components\resources\tabs.blade.php", "PHP", 30, 0, 0, 0, 5, 35
"c:\wamp64\www\PK\resources\views\vendor\filament-panels\components\sidebar\group.blade.php", "PHP", 204, 0, 0, 0, 21, 225
"c:\wamp64\www\PK\resources\views\vendor\filament-panels\components\sidebar\index.blade.php", "PHP", 163, 0, 0, 2, 15, 180
"c:\wamp64\www\PK\resources\views\vendor\filament-panels\components\sidebar\item.blade.php", "PHP", 145, 0, 0, 1, 9, 155
"c:\wamp64\www\PK\resources\views\vendor\filament-panels\components\tenant-menu.blade.php", "PHP", 151, 0, 0, 0, 18, 169
"c:\wamp64\www\PK\resources\views\vendor\filament-panels\components\theme-switcher\button.blade.php", "PHP", 28, 0, 0, 0, 3, 31
"c:\wamp64\www\PK\resources\views\vendor\filament-panels\components\theme-switcher\index.blade.php", "PHP", 23, 0, 0, 0, 4, 27
"c:\wamp64\www\PK\resources\views\vendor\filament-panels\components\topbar\database-notifications-trigger.blade.php", "PHP", 9, 0, 0, 0, 1, 10
"c:\wamp64\www\PK\resources\views\vendor\filament-panels\components\topbar\index.blade.php", "PHP", 162, 0, 0, 0, 22, 184
"c:\wamp64\www\PK\resources\views\vendor\filament-panels\components\topbar\item.blade.php", "PHP", 71, 0, 0, 1, 6, 78
"c:\wamp64\www\PK\resources\views\vendor\filament-panels\components\unsaved-action-changes-alert.blade.php", "PHP", 35, 0, 0, 0, 3, 38
"c:\wamp64\www\PK\resources\views\vendor\filament-panels\components\user-menu.blade.php", "PHP", 86, 0, 0, 0, 14, 100
"c:\wamp64\www\PK\resources\views\vendor\filament-panels\pages\auth\edit-profile.blade.php", "PHP", 11, 0, 0, 0, 2, 13
"c:\wamp64\www\PK\resources\views\vendor\filament-panels\pages\auth\email-verification\email-verification-prompt.blade.php", "PHP", 13, 0, 0, 0, 3, 16
"c:\wamp64\www\PK\resources\views\vendor\filament-panels\pages\auth\login.blade.php", "PHP", 17, 0, 0, 0, 6, 23
"c:\wamp64\www\PK\resources\views\vendor\filament-panels\pages\auth\password-reset\request-password-reset.blade.php", "PHP", 16, 0, 0, 0, 5, 21
"c:\wamp64\www\PK\resources\views\vendor\filament-panels\pages\auth\password-reset\reset-password.blade.php", "PHP", 11, 0, 0, 0, 4, 15
"c:\wamp64\www\PK\resources\views\vendor\filament-panels\pages\auth\register.blade.php", "PHP", 17, 0, 0, 0, 6, 23
"c:\wamp64\www\PK\resources\views\vendor\filament-panels\pages\dashboard.blade.php", "PHP", 15, 0, 0, 0, 2, 17
"c:\wamp64\www\PK\resources\views\vendor\filament-panels\pages\tenancy\edit-tenant-profile.blade.php", "PHP", 9, 0, 0, 0, 2, 11
"c:\wamp64\www\PK\resources\views\vendor\filament-panels\pages\tenancy\register-tenant.blade.php", "PHP", 9, 0, 0, 0, 2, 11
"c:\wamp64\www\PK\resources\views\vendor\filament-panels\resources\pages\create-record.blade.php", "PHP", 19, 0, 0, 0, 3, 22
"c:\wamp64\www\PK\resources\views\vendor\filament-panels\resources\pages\edit-record.blade.php", "PHP", 47, 0, 0, 0, 6, 53
"c:\wamp64\www\PK\resources\views\vendor\filament-panels\resources\pages\list-records.blade.php", "PHP", 13, 0, 0, 0, 4, 17
"c:\wamp64\www\PK\resources\views\vendor\filament-panels\resources\pages\manage-related-records.blade.php", "PHP", 24, 0, 0, 0, 5, 29
"c:\wamp64\www\PK\resources\views\vendor\filament-panels\resources\pages\view-record.blade.php", "PHP", 45, 0, 0, 0, 3, 48
"c:\wamp64\www\PK\resources\views\vendor\filament-panels\resources\relation-manager.blade.php", "PHP", 7, 0, 0, 0, 5, 12
"c:\wamp64\www\PK\resources\views\vendor\filament-panels\widgets\account-widget.blade.php", "PHP", 37, 0, 0, 0, 6, 43
"c:\wamp64\www\PK\resources\views\vendor\filament-panels\widgets\filament-info-widget.blade.php", "PHP", 66, 0, 0, 0, 5, 71
"Total", "-", 3675, 7, 3, 11, 544, 4240